1111111111111111111
1000006000700000001
1000006000700000001
10000B6000700000001
1000026444700000001
1000006122700000001
1200006100700000001
1000006100700050001
1002226000740000041
1000006B007900000A1
19000A6200700000001
1000006001700100001
0000006011701100000