1111111111111111111
1000000000000000001
1000000000011000001
1000010000000000001
1000000000000000001
1000000000000000001
1000000100000000001
1000000000010000001
1000000000000000001
1000001000000000001
1010000000000000031
1000000000000000021
0000000040000500000