1111111111111111111
1000000000000000001
1000000000000000001
1000000000000000001
1000000000000000011
1000000000001001001
1000000000000000001
1000000100000000001
1000000000000000001
1000000000000000001
1000100000000000001
1000000000000000501
000000B00123456789A0