1111111111111111111
1000000000000000000
10009000000000000A1
1000000000400000001
1000000000100000001
150009000000000A001
1200000000000000001
10000000000090000A1
1000000000000000001
19000000000000A0001
1000000000000000001
1000900000A00000001
0000444444444444441