1111111111111111111
1000000000000000051
1B00000000000000001
1200000000000000001
1009000000000A00011
1000000000000400001
1000100000000100001
1000000000000000001
1000000000000000001
1200000000000000001
1000000000000000001
1000200000000000001
0000000000000000006