1111111111111111111
1000060000600000001
1000060000600000001
1000060500600000001
1000017777100000001
1000B10000100000001
1300214444100000001
1000012222100000001
1B00000000000000001
1200300000000000001
1000000000000000001
1003000000000000001
00B0000000000000000