1111111111111111111
1000000000000000001
1000000000000000001
1000100033330000001
1002130000000000001
1000100000000000001
1540100000000200001
1220101000000000001
1000000000000000001
1000000010000001001
1000000000000000001
1000011000000000001
0001444444444444000