1111111111111111111
1000000000000000001
1000000000000000001
1000000000000050001
10000049000000000A1
1002002000000000001
1000000000000000001
1000000000000000001
1200000000000000001
1000004444000000001
1000022222200000001
1111100000000000001
0000000000001000000