1111111111111111111
1000000000000000001
1000000000000000001
1000000000000001001
1000000000000001001
1000000000003001001
1000000000000001001
1000000000000021001
1003102000001001001
1000100000300001001
1300100003000001001
1000100000000001001
0003144050444441000