1111111111111111111
1000000100010000001
1000000100010000001
1000000100015000001
1000000100011000001
1000000100B10000001
1B00000100110000011
1100000100010000001
1000000110011000001
1000100600070000001
1000000600170000011
10019000000000A0001
0000444444444440000