1111111111111111111
1000000000000000001
1000000000000500001
1000000000000000001
1000020000002200001
1000000077700000001
1004000000000000001
1002200000000000001
10000000000000000B1
1000000000000000021
10000900000000A0001
1001000000000000001
0011444444444444400