1111111111111111111
1060000000000000001
1060000000000000001
1060000000000000001
1560000000000000001
17000000000000000B1
1400300000000000011
1200000000000020001
1000000002000000001
1000000000000000001
1000000000010000001
100009000000000A001
0000044444444444000